#,#,#,#,#,#,#,#,#,#,#,#,#,#,#
#,#,#,#,#,#,#,#,#,#,#,#,#,#,#
#,#,#,#,#,#,.,.,.,#,#,#,#,#,#
#,#,#,#,.,.,.,.,.,.,.,#,#,#,#
#,#,#,.,.,.,.,.,.,.,.,.,#,#,#
#,#,#,.,.,.,.,.,.,.,.,.,#,#,#
#,#,.,.,.,.,.,.,.,.,.,.,.,#,#
#,#,.,.,.,.,.,.,.,.,.,.,.,#,#
#,#,.,.,.,.,.,.,.,.,.,.,.,#,#
#,#,#,.,.,.,.,.,.,.,.,.,#,#,#
#,#,#,.,.,.,.,.,.,.,.,.,#,#,#
#,#,#,#,.,.,.,.,.,.,.,#,#,#,#
#,#,#,#,#,#,.,.,.,#,#,#,#,#,#
#,#,#,#,#,#,#,#,#,#,#,#,#,#,#
#,#,#,#,#,#,#,#,#,#,#,#,#,#,#
